11111111111111111111111
100000000C0000CC0000001
100100C0000000000000001
1001000111000C000000001
100C1000011111101111001
100000000000000C0001001
10000010101000000001001
1000000100C000000000001
10000001P1010001111E001
11111111111111111111111